{
  "width": 20,
  "height": 18,
  "tileset": "pallet_town_tileset",
  "layers": {
    "ground": [
      [0, 0, 0, 0, 0, 0, 0, 0, 2, 2, 2, 0, 0, 0, 0, 0, 0, 0, 0, 0],
      [0, 0, 0, 0, 0, 0, 0, 0, 2, 0, 2, 0, 0, 0, 0, 0, 0, 0, 0, 0],
      [0, 0, 0, 0, 0, 0, 0, 2, 2, 0, 2, 2, 0, 0, 0, 0, 0, 0, 0, 0],
      [0, 0, 0, 0, 0, 0, 2, 2, 1, 1, 1, 2, 2, 0, 0, 0, 0, 0, 0, 0],
      [0, 0, 0, 0, 0, 0, 2, 1, 1, 1, 1, 1, 2, 0, 0, 0, 0, 0, 0, 0],
      [0, 0, 0, 0, 0, 0, 2, 1, 1, 1, 1, 1, 2, 0, 0, 0, 0, 0, 0, 0],
      [0, 0, 0, 0, 0, 0, 2, 2, 2, 2, 2, 2, 2, 0, 0, 0, 0, 0, 0, 0],
      [0, 0, 0, 0, 0, 0, 0, 0, 2, 0, 2, 0, 0, 0, 0, 0, 0, 0, 0, 0],
      [3, 3, 0, 0, 0, 0, 0, 0, 2, 0, 2, 0, 0, 0, 0, 0, 0, 0, 0, 0],
      [3, 3, 3, 0, 0, 0, 3, 3, 3, 0, 2, 2, 2, 2, 2, 0, 0, 0, 0, 0],
      [3, 3, 3, 0, 0, 0, 3, 3, 3, 0, 0, 0, 0, 0, 2, 0, 0, 0, 0, 0],
      [0, 0, 0, 0, 0, 0, 3, 3, 3, 0, 0, 0, 0, 0, 2, 2, 2, 2, 0, 0],
      [0, 0, 2, 2, 2, 2, 2, 0, 0, 0, 0, 0, 0, 0, 0, 0, 0, 2, 0, 0],
      [0, 0, 2, 1, 1, 1, 2, 0, 0, 0, 0, 0, 2, 2, 2, 2, 2, 2, 0, 0],
      [0, 0, 2, 1, 1, 1, 2, 0, 0, 0, 0, 0, 2, 1, 1, 1, 1, 2, 0, 0],
      [0, 0, 2, 1, 1, 1, 2, 0, 0, 0, 0, 0, 2, 1, 1, 1, 1, 2, 0, 0],
      [0, 0, 2, 2, 2, 2, 2, 0, 0, 0, 0, 0, 2, 2, 2, 2, 2, 2, 0, 0],
      [0, 0, 0, 0, 0, 2, 2, 2, 2, 2, 2, 2, 2, 0, 0, 0, 0, 0, 0, 0]
    ],
    "decorations": [
      [4, 4, 4, 4, 4, 4, 4, 4, 0, 5, 0, 4, 4, 4, 4, 4, 4, 4, 4, 4],
      [4, 0, 0, 0, 0, 0, 0, 0, 0, 0, 0, 0, 0, 0, 0, 0, 0, 0, 0, 4],
      [4, 0, 0, 0, 0, 0, 0, 0, 0, 0, 0, 0, 0, 0, 0, 0, 0, 0, 0, 4],
      [4, 0, 0, 0, 0, 0, 0, 0, 0, 0, 0, 0, 0, 0, 0, 0, 0, 0, 0, 4],
      [4, 0, 0, 0, 0, 0, 0, 0, 0, 0, 0, 0, 0, 0, 0, 0, 0, 0, 0, 4],
      [4, 0, 0, 0, 0, 0, 0, 0, 0, 0, 0, 0, 0, 0, 0, 0, 0, 0, 0, 4],
      [4, 0, 0, 0, 0, 0, 0, 0, 0, 5, 0, 0, 0, 0, 0, 0, 0, 0, 0, 4],
      [4, 0, 0, 0, 0, 0, 0, 0, 0, 0, 0, 0, 0, 0, 0, 0, 0, 0, 0, 4],
      [0, 0, 0, 0, 0, 0, 0, 0, 0, 0, 0, 0, 0, 0, 0, 0, 0, 0, 0, 4],
      [0, 0, 0, 0, 0, 0, 0, 0, 0, 0, 0, 0, 0, 0, 0, 0, 0, 0, 0, 4],
      [0, 0, 0, 0, 0, 0, 0, 0, 0, 0, 0, 0, 0, 0, 0, 0, 0, 0, 0, 4],
      [4, 0, 0, 0, 0, 0, 0, 0, 0, 0, 0, 0, 0, 0, 0, 0, 0, 0, 0, 4],
      [4, 0, 0, 0, 0, 5, 0, 0, 0, 0, 0, 0, 0, 0, 0, 0, 0, 0, 0, 4],
      [4, 0, 0, 0, 0, 0, 0, 0, 0, 0, 0, 0, 0, 0, 0, 0, 0, 0, 0, 4],
      [4, 0, 0, 0, 0, 0, 0, 0, 0, 0, 0, 0, 0, 0, 0, 0, 0, 0, 0, 4],
      [4, 0, 0, 0, 0, 0, 0, 0, 0, 0, 0, 0, 0, 0, 0, 0, 0, 0, 0, 4],
      [4, 0, 0, 0, 0, 0, 0, 0, 5, 0, 0, 5, 0, 0, 0, 0, 0, 0, 0, 4],
      [4, 4, 4, 4, 4, 0, 0, 0, 0, 5, 0, 0, 0, 4, 4, 4, 4, 4, 4, 4]
    ],
    "collision": [
      [1, 1, 1, 1, 1, 1, 1, 1, 0, 1, 0, 1, 1, 1, 1, 1, 1, 1, 1, 1],
      [1, 0, 0, 0, 0, 0, 0, 0, 0, 0, 0, 0, 0, 0, 0, 0, 0, 0, 0, 1],
      [1, 0, 0, 0, 0, 0, 0, 0, 0, 0, 0, 0, 0, 0, 0, 0, 0, 0, 0, 1],
      [1, 0, 0, 0, 0, 0, 0, 0, 1, 1, 1, 0, 0, 0, 0, 0, 0, 0, 0, 1],
      [1, 0, 0, 0, 0, 0, 0, 1, 1, 1, 1, 1, 0, 0, 0, 0, 0, 0, 0, 1],
      [1, 0, 0, 0, 0, 0, 0, 1, 1, 1, 1, 1, 0, 0, 0, 0, 0, 0, 0, 1],
      [1, 0, 0, 0, 0, 0, 0, 0, 0, 1, 0, 0, 0, 0, 0, 0, 0, 0, 0, 1],
      [1, 0, 0, 0, 0, 0, 0, 0, 0, 0, 0, 0, 0, 0, 0, 0, 0, 0, 0, 1],
      [1, 1, 0, 0, 0, 0, 0, 0, 0, 0, 0, 0, 0, 0, 0, 0, 0, 0, 0, 1],
      [1, 1, 1, 0, 0, 0, 1, 1, 1, 0, 0, 0, 0, 0, 0, 0, 0, 0, 0, 1],
      [1, 1, 1, 0, 0, 0, 1, 1, 1, 0, 0, 0, 0, 0, 0, 0, 0, 0, 0, 1],
      [1, 0, 0, 0, 0, 0, 1, 1, 1, 0, 0, 0, 0, 0, 0, 0, 0, 0, 0, 1],
      [1, 0, 0, 0, 0, 1, 0, 0, 0, 0, 0, 0, 0, 0, 0, 0, 0, 0, 0, 1],
      [1, 0, 0, 1, 1, 1, 0, 0, 0, 0, 0, 0, 0, 0, 0, 0, 0, 0, 0, 1],
      [1, 0, 0, 1, 1, 1, 0, 0, 0, 0, 0, 0, 0, 1, 1, 1, 1, 0, 0, 1],
      [1, 0, 0, 1, 1, 1, 0, 0, 0, 0, 0, 0, 0, 1, 1, 1, 1, 0, 0, 1],
      [1, 0, 0, 0, 0, 0, 0, 0, 1, 0, 0, 1, 0, 0, 0, 0, 0, 0, 0, 1],
      [1, 1, 1, 1, 1, 0, 0, 0, 0, 1, 0, 0, 0, 1, 1, 1, 1, 1, 1, 1]
    ]
  },
  "items": [
    {
      "id": "pallet_potion",
      "item_id": "potion",
      "tile_x": 3,
      "tile_y": 9
    },
    {
      "id": "pallet_pokeball_1",
      "item_id": "poke-ball",
      "tile_x": 4,
      "tile_y": 9
    },
    {
      "id": "pallet_pokeball_2",
      "item_id": "poke-ball",
      "tile_x": 5,
      "tile_y": 9
    }
  ],
  "warps": [
    {
      "x": 8,
      "y": 0,
      "target_map": "route_1",
      "target_x": 7,
      "target_y": 28,
      "warp_type": "route"
    },
    {
      "x": 10,
      "y": 0,
      "target_map": "route_1",
      "target_x": 9,
      "target_y": 28,
      "warp_type": "route"
    },
    {
      "x": 4,
      "y": 14,
      "target_map": "player_house_1f",
      "target_x": 3,
      "target_y": 7,
      "warp_type": "door"
    },
    {
      "x": 14,
      "y": 14,
      "target_map": "rival_house_1f",
      "target_x": 3,
      "target_y": 7,
      "warp_type": "door"
    },
    {
      "x": 9,
      "y": 4,
      "target_map": "oaks_lab",
      "target_x": 4,
      "target_y": 11,
      "warp_type": "door"
    }
  ],
  "npcs": [
    {
      "id": "girl",
      "tile_x": 10,
      "tile_y": 12,
      "direction": "down",
      "dialog": "Technology is incredible!"
    },
    {
      "id": "boy",
      "tile_x": 5,
      "tile_y": 10,
      "direction": "right",
      "dialog": "I love Pokemon!"
    }
  ]
}
