{
  "width": 12,
  "height": 30,
  "tileset": "route_1_tileset",
  "layers": {
    "ground": [
      [0, 0, 0, 0, 0, 0, 0, 2, 0, 2, 0, 0],
      [0, 0, 0, 0, 0, 0, 0, 2, 0, 2, 0, 0],
      [0, 0, 0, 0, 0, 0, 0, 2, 0, 2, 0, 0],
      [0, 0, 0, 0, 0, 0, 0, 2, 2, 2, 0, 0],
      [0, 0, 0, 0, 0, 0, 0, 0, 0, 0, 0, 0],
      [0, 0, 0, 0, 0, 0, 0, 0, 0, 0, 0, 0],
      [0, 0, 0, 0, 0, 0, 0, 2, 2, 2, 0, 0],
      [0, 0, 0, 0, 0, 0, 0, 2, 2, 2, 0, 0],
      [0, 0, 0, 0, 0, 0, 0, 2, 2, 2, 0, 0],
      [0, 0, 0, 0, 0, 0, 0, 2, 2, 2, 0, 0],
      [0, 0, 0, 0, 0, 0, 0, 0, 0, 0, 0, 0],
      [0, 0, 0, 0, 0, 0, 0, 0, 0, 0, 0, 0],
      [0, 0, 0, 0, 0, 0, 0, 2, 2, 2, 0, 0],
      [0, 0, 0, 0, 0, 0, 0, 2, 2, 2, 0, 0],
      [0, 0, 0, 0, 0, 0, 0, 2, 2, 2, 0, 0],
      [0, 0, 0, 0, 0, 0, 0, 2, 2, 2, 0, 0],
      [0, 0, 0, 0, 0, 0, 0, 0, 0, 0, 0, 0],
      [0, 0, 0, 0, 0, 0, 0, 0, 0, 0, 0, 0],
      [0, 0, 0, 0, 0, 0, 0, 2, 2, 2, 0, 0],
      [0, 0, 0, 0, 0, 0, 0, 2, 2, 2, 0, 0],
      [0, 0, 0, 0, 0, 0, 0, 2, 2, 2, 0, 0],
      [0, 0, 0, 0, 0, 0, 0, 2, 2, 2, 0, 0],
      [0, 0, 0, 0, 0, 0, 0, 0, 0, 0, 0, 0],
      [0, 0, 0, 0, 0, 0, 0, 0, 0, 0, 0, 0],
      [0, 0, 0, 0, 0, 0, 0, 2, 2, 2, 0, 0],
      [0, 0, 0, 0, 0, 0, 0, 2, 2, 2, 0, 0],
      [0, 0, 0, 0, 0, 0, 0, 2, 2, 2, 0, 0],
      [0, 0, 0, 0, 0, 0, 0, 2, 2, 2, 0, 0],
      [0, 0, 0, 0, 0, 0, 0, 2, 2, 2, 0, 0],
      [0, 0, 0, 0, 0, 0, 0, 2, 0, 2, 0, 0]
    ],
    "decorations": [
      [4, 4, 4, 4, 4, 4, 4, 0, 5, 0, 4, 4],
      [4, 0, 0, 0, 0, 0, 0, 0, 0, 0, 0, 4],
      [4, 0, 0, 0, 0, 0, 0, 0, 0, 0, 0, 4],
      [4, 0, 0, 0, 0, 0, 0, 0, 0, 0, 0, 4],
      [4, 0, 0, 0, 0, 0, 0, 0, 0, 0, 0, 4],
      [4, 0, 0, 0, 0, 0, 0, 0, 0, 0, 0, 4],
      [4, 0, 0, 0, 0, 0, 0, 0, 0, 0, 0, 4],
      [4, 0, 0, 0, 0, 0, 0, 0, 0, 0, 0, 4],
      [4, 0, 0, 0, 0, 0, 0, 0, 0, 0, 0, 4],
      [4, 0, 0, 0, 0, 0, 0, 0, 0, 0, 0, 4],
      [4, 0, 0, 0, 0, 0, 0, 0, 0, 0, 0, 4],
      [4, 0, 0, 0, 0, 0, 0, 0, 0, 0, 0, 4],
      [4, 0, 0, 0, 0, 0, 0, 0, 0, 0, 0, 4],
      [4, 0, 0, 0, 0, 0, 0, 0, 0, 0, 0, 4],
      [4, 0, 0, 0, 0, 0, 0, 0, 0, 0, 0, 4],
      [4, 0, 0, 0, 0, 0, 5, 0, 0, 0, 0, 4],
      [4, 0, 0, 0, 0, 0, 0, 0, 0, 0, 0, 4],
      [4, 0, 0, 0, 0, 0, 0, 0, 0, 0, 0, 4],
      [4, 0, 0, 0, 0, 0, 0, 0, 0, 0, 0, 4],
      [4, 0, 0, 0, 0, 0, 0, 0, 0, 0, 0, 4],
      [4, 0, 0, 0, 0, 0, 0, 0, 0, 0, 0, 4],
      [4, 0, 0, 0, 0, 0, 0, 0, 0, 0, 0, 4],
      [4, 0, 0, 0, 0, 0, 0, 0, 0, 0, 0, 4],
      [4, 0, 0, 0, 0, 0, 0, 0, 0, 0, 0, 4],
      [4, 0, 0, 0, 0, 0, 0, 0, 0, 0, 0, 4],
      [4, 0, 0, 0, 0, 0, 0, 0, 0, 0, 0, 4],
      [4, 0, 0, 0, 0, 0, 0, 0, 0, 0, 0, 4],
      [4, 0, 0, 0, 0, 5, 0, 0, 0, 0, 0, 4],
      [4, 0, 0, 0, 0, 0, 0, 0, 0, 0, 0, 4],
      [4, 4, 4, 4, 4, 4, 4, 0, 5, 0, 4, 4]
    ],
    "collision": [
      [1, 1, 1, 1, 1, 1, 1, 0, 1, 0, 1, 1],
      [1, 0, 0, 0, 0, 0, 0, 0, 0, 0, 0, 1],
      [1, 0, 0, 0, 0, 0, 0, 0, 0, 0, 0, 1],
      [1, 0, 0, 0, 0, 0, 0, 0, 0, 0, 0, 1],
      [1, 0, 0, 0, 0, 0, 0, 0, 0, 0, 0, 1],
      [1, 0, 0, 0, 0, 0, 0, 0, 0, 0, 0, 1],
      [1, 0, 0, 0, 0, 0, 0, 0, 0, 0, 0, 1],
      [1, 0, 0, 0, 0, 0, 0, 0, 0, 0, 0, 1],
      [1, 0, 0, 0, 0, 0, 0, 0, 0, 0, 0, 1],
      [1, 0, 0, 0, 0, 0, 0, 0, 0, 0, 0, 1],
      [1, 0, 0, 0, 0, 0, 0, 0, 0, 0, 0, 1],
      [1, 0, 0, 0, 0, 0, 0, 0, 0, 0, 0, 1],
      [1, 0, 0, 0, 0, 0, 0, 0, 0, 0, 0, 1],
      [1, 0, 0, 0, 0, 0, 0, 0, 0, 0, 0, 1],
      [1, 0, 0, 0, 0, 0, 0, 0, 0, 0, 0, 1],
      [1, 0, 0, 0, 0, 0, 1, 0, 0, 0, 0, 1],
      [1, 0, 0, 0, 0, 0, 0, 0, 0, 0, 0, 1],
      [1, 0, 0, 0, 0, 0, 0, 0, 0, 0, 0, 1],
      [1, 0, 0, 0, 0, 0, 0, 0, 0, 0, 0, 1],
      [1, 0, 0, 0, 0, 0, 0, 0, 0, 0, 0, 1],
      [1, 0, 0, 0, 0, 0, 0, 0, 0, 0, 0, 1],
      [1, 0, 0, 0, 0, 0, 0, 0, 0, 0, 0, 1],
      [1, 0, 0, 0, 0, 0, 0, 0, 0, 0, 0, 1],
      [1, 0, 0, 0, 0, 0, 0, 0, 0, 0, 0, 1],
      [1, 0, 0, 0, 0, 0, 0, 0, 0, 0, 0, 1],
      [1, 0, 0, 0, 0, 0, 0, 0, 0, 0, 0, 1],
      [1, 0, 0, 0, 0, 0, 0, 0, 0, 0, 0, 1],
      [1, 0, 0, 0, 0, 1, 0, 0, 0, 0, 0, 1],
      [1, 0, 0, 0, 0, 0, 0, 0, 0, 0, 0, 1],
      [1, 1, 1, 1, 1, 1, 1, 0, 1, 0, 1, 1]
    ]
  },
  "warps": [
    {
      "x": 7,
      "y": 29,
      "target_map": "pallet_town",
      "target_x": 8,
      "target_y": 1,
      "warp_type": "route"
    },
    {
      "x": 9,
      "y": 29,
      "target_map": "pallet_town",
      "target_x": 10,
      "target_y": 1,
      "warp_type": "route"
    }
  ]
}
